            RRRRRRRRRRRRRRRRRRRRRRRRRRRRRRRRRRRRRRRRRRRRRRRRRRRRRRRRRRRRRRRRRRRRRRRRRRRRRRRRRRRR
                                                                                               *
               ***                         ***     ***                             ***         *
                                                               ****                            *
                          ****   ****                      ***         ****   ****             *
     SSSSSS         ***                       ****    ***                   ***     ****       *
           ***                 **                **                                            **
******************************************************************************************EEEEEE***
                                                                                         **********