            RRRRRRRRRRRRRRRRRRRRRRRRRRRRRRRRRRRRRRRRRRRRRRRRRRRRRRRRRRRRRRRRRRRRRRRRRRRRRRRRRRRR
                                                                                               *
               ***                         ***     ***                             ***         *
                                                               ****                            *
                          ****   ****                      ***         ****   ****             *
     SSSSSS         ***                       ****    ***                   ***     ****       *
           ***  ***            ****        ***  *****   ******     ***     ***     *           *                            **                                            **
******************************************************************************************EEEEEE***
                                                                                         **********